xxxxxxxxxx
x........x
x.s......x
x........x
x...c....x
x........x
x........x
x......f.x
x........x
xxxxxxxxxx
